A	AH
A(2)	EY
ALFRED	AE L F R IH D
AN	AE N
AN(2)	AH N
ARTICLE	AA R T AH K AH L
ARTICLE(2)	AA R T IH K AH L
CHECK	CH EH K
HACKER	HH AE K ER
LIGHT	L AY T
ME	M IY
NEWS	N UW Z
NEWS(2)	N Y UW Z
OF	AH V
OFF	AO F
ON	AA N
ON(2)	AO N
PLAY	P L EY
REMIND	R IY M AY N D
SONG	S AO NG
STOP	S T AA P
TELL	T EH L
THE	DH AH
THE(2)	DH IY
TIME	T AY M
TURN	T ER N
UP	AH P
WAKE	W EY K
